NO ./textures/wall1.png
SO ./textures/wall2.png
WE ./textures/wall3.png
EA ./textures/wall4.png
F 220,100,0
C 225,30,0

11111  11111
10001  10001
10001  10001
10001  10N01
10001  10001
11111  11111