

TN=cobble_01.png
TE=cobble_01.png
TS=cobble_01.png
TW=cobble_01.png


1111111111111111111111111111111111
1444444444444444444444444444444441
1444444444444444444444444444444441
1444444444444444444444444444444441
1444444444444444444444444444444441
1444444444444444444444444444444441
1444444444444444444444444444444441
1444444444444444444444444444444441
1444444444444444444444444444444441
1444444444444444444444444444444441
1444444444444444444444444444E44441
1444444444444444444444444444444441
1444444444444444444444444444444441
1444444444444444444444444444444441
1444444444444444444444444444444441
1444444444444444444444444444444441
1444444444444444444444444444444441
1444444444444444444444444444444441
1444444444444444444444444444444441
1444444444444444444444444444444441
1444444444444444444444444444444441
1444444444444444444444444444444441
1444444444444444444444444444444441
1444444444444444444444444444444441
1444444444444444444444444444444441
1444444444444444444444444444444441
1444444444444444444444444444444441
1444444444444444444444444444444441
1444444444444444444444444444444441
1444444444444444444444444444444441
1444444444444444444444444444444441
1444444444444444444444444444444441
1444444444444444444444444444444441
1444444444444444444444444444444441
1444444444444444444444444444444441
1444444444444444444444444444444441
1444444444444444444444444444444441
1444444444444444444444444444444441
1444444444444444444444444444444441
1444444444444444444444444444444441
1444444444444444444444444444444441
1444444444444444444444444444444441
1444444444444444444444444444444441
1444444444444444444444444444444441
1444444444444444444444444444444441
1444444444444444444444444444444441
1444444444444444444444444444444441
1444444444444444444444444444444441
1444444444444444444444444444444441
1444444444444444444444444444444441
1444444444444444444444444444444441
1444444444444444444444444444444441
1444444444444444444444444444444441
1444444444444444444444444444444441
1444444444444444444444444444444441
1444444444444444444444444444444441
1444444444444444444444444444444441
1444444444444444444444444444444441
1444444444444444444444444444444441
1444444444444444444444444444444441
1444444444444444444444444444444441
1444444444444444444444444444444441
1444444444444444444444444444444441
1444444444444444444444444444444441
1444444444444444444444444444444441
1444444444444444444444444444444441
1444444444444444444444444444444441
1444444444444444444444444444444441
1444444444444444444444444444444441
1444444444444444444444444444444441
1444444444444444444444444444444441
1444444444444444444444444444444441
1444444444444444444444444444444441
1444444444444444444444444444444441
1444444444444444444444444444444441
1444444444444444444444444444444441
1444444444444444444444444444444441
1444444444444444444444444444444441
1444444444444444444444444444444441
1444444444444444444444444444444441
1444444444444444444444444444444441
1444444444444444444444444444444441
1444444444444444444444444444444441
1444444444444444444444444444444441
1444444444444444444444444444444441
1444444444444444444444444444444441
1444444444444444444444444444444441
1444444444444444444444444444444441
1444444444444444444444444444444441
1444444444444444444444444444444441
1444444444444444444444444444444441
1444444444444444444444444444444441
1444444444444444444444444444444441
1444444444444444444444444444444441
1444444444444444444444444444444441
1444444444444444444444444444444441
1444444444444444444444444444444441
1444444444444444444444444444444441
1444444444444444444444444444444441
1444444444444444444444444444444441
1444444444444444444444444444444441
1444444444444444444444444444444441
1444444444444444444444444444444441
1444444444444444444444444444444441
1444444444444444444444444444444441
1444444444444444444444444444444441
1444444444444444444444444444444441
1444444444444444444444444444444441
1444444444444444444444444444444441
1444444444444444444444444444444441
1444444444444444444444444444444441
1444444444444444444444444444444441
1444444444444444444444444444444441
1444444444444444444444444444444441
1444444444444444444444444444444441
1444444444444444444444444444444441
1444444444444444444444444444444441
1444444444444444444444444444444441
1444444444444444444444444444444441
1444444444444444444444444444444441
1444444444444444444444444444444441
1444444444444444444444444444444441
1444444444444444444444444444444441
1444444444444444444444444444444441
1444444444444444444444444444444441
1444444444444444444444444444444441
1444444444444444444444444444444441
1444444444444444444444444444444441
1444444444444444444444444444444441
1444444444444444444444444444444441
1444444444444444444444444444444441
1444444444444444444444444444444441
1444444444444444444444444444444441
1444444444444444444444444444444441
1444444444444444444444444444444441
1444444444444444444444444444444441
1444444444444444444444444444444441
1444444444444444444444444444444441
1444444444444444444444444444444441
1444444444444444444444444444444441
1444444444444444444444444444444441
1444444444444444444444444444444441
1444444444444444444444444444444441
1444444444444444444444444444444441
1444444444444444444444444444444441
1444444444444444444444444444444441
1444444444444444444444444444444441
1444444444444444444444444444444441
1444444444444444444444444444444441
1444444444444444444444444444444441
1444444444444444444444444444444441
1444444444444444444444444444444441
1444444444444444444444444444444441
1444444444444444444444444444444441
1444444444444444444444444444444441
1444444444444444444444444444444441
1444444444444444444444444444444441
1444444444444444444444444444444441
1444444444444444444444444444444441
1444444444444444444444444444444441
1444444444444444444444444444444441
1444444444444444444444444444444441
1444444444444444444444444444444441
1444444444444444444444444444444441
1444444444444444444444444444444441
1444444444444444444444444444444441
1444444444444444444444444444444441
1444444444444444444444444444444441
1444444444444444444444444444444441
1444444444444444444444444444444441
1444444444444444444444444444444441
1444444444444444444444444444444441
1444444444444444444444444444444441
1444444444444444444444444444444441
1444444444444444444444444444444441
1444444444444444444444444444444441
1444444444444444444444444444444441
1444444444444444444444444444444441
1444444444444444444444444444444441
1444444444444444444444444444444441
1444444444444444444444444444444441
1444444444444444444444444444444441
1444444444444444444444444444444441
1444444444444444444444444444444441
1444444444444444444444444444444441
1444444444444444444444444444444441
1444444444444444444444444444444441
1444444444444444444444444444444441
1444444444444444444444444444444441
1444444444444444444444444444444441
1444444444444444444444444444444441
1444444444444444444444444444444441
1444444444444444444444444444444441
1444444444444444444444444444444441
1444444444444444444444444444444441
1444444444444444444444444444444441
1444444444444444444444444444444441
1444444444444444444444444444444441
1444444444444444444444444444444441
1444444444444444444444444444444441
1444444444444444444444444444444441
1444444444444444444444444444444441
1444444444444444444444444444444441
1444444444444444444444444444444441
1444444444444444444444444444444441
1444444444444444444444444444444441
1444444444444444444444444444444441
1444444444444444444444444444444441
1444444444444444444444444444444441
1444444444444444444444444444444441
1444444444444444444444444444444441
1444444444444444444444444444444441
1444444444444444444444444444444441
1444444444444444444444444444444441
1444444444444444444444444444444441
1444444444444444444444444444444441
1444444444444444444444444444444441
1444444444444444444444444444444441
1444444444444444444444444444444441
1444444444444444444444444444444441
1444444444444444444444444444444441
1444444444444444444444444444444441
1444444444444444444444444444444441
1444444444444444444444444444444441
1444444444444444444444444444444441
1444444444444444444444444444444441
1444444444444444444444444444444441
1444444444444444444444444444444441
1444444444444444444444444444444441
1444444444444444444444444444444441
1444444444444444444444444444444441
1444444444444444444444444444444441
1444444444444444444444444444444441
1444444444444444444444444444444441
1444444444444444444444444444444441
1444444444444444444444444444444441
1444444444444444444444444444444441
1444444444444444444444444444444441
1444444444444444444444444444444441
1444444444444444444444444444444441
1444444444444444444444444444444441
1444444444444444444444444444444441
1444444444444444444444444444444441
1444444444444111111111111114444441
1444444444444144444444444414444441
1444444444444144444444444444444441
1444444444444144444444444414444441
1111111111111111111111111111111111
