
TN=cobble_01.png
TE=cobble_01.png
TS=cobble_01.png
TW=cobble_01.png


1111111111111111111111111111111111
1000000000000000000000000000000001
1000000000000000000000000000000001
1000000000000000000000000000000001
1000000000000000000000000000000001
1000000000000000000000000000000001
1000000000000000000000000000000001
1000000000000000000000000000000001
1000000000000000000000000000000001
1000000000000000000000000000000001
1000000000000000000000000000E00001
1000000000000000000000000000000001
1000000050000000000000000000000001
1000000000000000000000000000000001
1000000000000000000000000000000001
1000000000000000000000000000000001
1000000000000000000000000000000001
1000000000000111111111111110000001
1000000000000111111111111110000001
1000000000000111111111111110000001
1000000000000111111111111110000001
1111111111111111111111111111111111
