
TN=cobble_01.png
TE=cobble_01.png
TS=cobble_01.png
TW=cobble_01.png
CC=0x262C69FF
CF=0x21130dFF

1111111111111111111111111111111111
1000000000000000000000000000000001
1000000000000000000000000000000001
1000000000000000000000000000000001
1000000000000000000000000000000001
1000000000000000000000000000000001
1000000000000000000000000000000001
1000000000000000000000000000000001
1000000000000000000000000000000001
1000000000000000000000000000000001
1000000000000000000000000000E00001
1000000000000000000000000000000001
1000000000000000000000000000000001
1000000000000000000000000000000001
1000000000000000000000000000000001
1000000000000000000000000000000001
1000000000000000000000000000000001
1000000000000111111111111110000001
1000000000000100000000000010000001
1000000000000100000000000000000001
1000000000000100000000000010000001
1111111111111111111111111111111111
