
TN=N.png
TE=E.png
TS=S.png
TW=W.png


111111111111
100000000001
100000000001
100000000001
100000000001
100000000001
100000000001
1000S0000001
100000000001
100000000001
100000000001
100000000001
100000000001
100000000001
100000000001
100000000001
100000000001
100000001111
100000001111
100000001111
100000001111
100000001111
100111101111
100111101111
100111101111
100111101111
111111111111
