TN=wall1.png
TE=wall2.png
TS=wall3.png
TW=wall4.png
CC=0xFFCCCCFF
CF=0xB800FFFF
111111111111111111111111111111111
100000000000000000110000000000001
111111111011000001110000000000001
100000001001000000000000000000001
111110111011000001110000000000001
100000000011000001110111111111111
111101111111110111000000100010001
111101111111110111010100100010001
110000001101010111000000100010001
10000000000000001100000000W000001
100000000000000011010100100010001
110000011101010111110111100110001
111101000001010111011110000010001
111111111111111111111111111111111
