
TN=cobble_01.png
TE=cobble_01.png
TS=cobble_01.png
TW=cobble_01.png
CC=0x262C69FF
CF=0x21130dFF

1111111111111111111111111111111111
1000000000000100000000100000000001
1000005000000100000500405000005001
1000000000000400000000100005000001
1000000000000100005000100000000001
1000000000005100000000100000000001
1111111111111111111111111111411111
1005000000000100000000001000000001
1000000000000100000000001000000001
1000005000000400000000001000000001
1000000000000100000500004000E00001
1000500005000100000000001000000001
1000000000000100000000001000000001
1111111111111100000000001111141111
1005000000000000000000000000000001
1000000000000000000000000000000001
1000000000000000000000000000000001
1111114111111111114111111111141111
1000000000000100000000000010000001
1000005000000100500000000010005001
1000000000000100000000050010000001
1111111111111111111111111111111111
