TN=N.png
TE=E.png
TS=S.png
TW=W.png
111111
100101
101001
1100N1
111111
