TN=wall1.png
TE=wall2.png
TS=wall3.png
TW=wall4.png

CF=0x262C69FF
CC=0x262C69FF

        1111111111111111111111111
        1000000000110000000000001
        1011000001110000000005001
        1001000000000000500000001
111111111011000001110000000000001
100000000011000001110111144411111
11110111111111011100000010001
11110111111111011101010010001
11000000110101011100000040001
10000000000000001100000010001
10005000000005001101510010001
11000001110101011111011110N0111
11110111 1110101 101111010001
11111111 1111111 111111111111
